NodeA	NodeB
a x	a	x
a y	a	y
a w	a	w
a v	a	v
a z	a	z
b x	b	x
b y	b	y
b w	b	w
b v	b	v
b z	b	z
c x	c	x
c y	c	y
c w	c	w
c v	c	v
c z	c	z
x a	x	a
y a	y	a
w a	w	a
v a	v	a
z a	z	a
x b	x	b
y b	y	b
w b	w	b
v b	v	b
z b	z	b
x c	x	c
y c	y	c
w c	w	c
v c	v	c
z c	z	c
